1111111111111111111111111111111111
1E0H00000000000C00000C000000000001
1010010100100000101H010000H0010101
1010010010101010001001000000010101
1P000H000C00C0000000000H00000000C1
1111111111111111111111111111111111